30
30
PPPPPPPPPPPPPPPPPPPPPPPPPPPPPP
PPPPPPPPPPPPPPPPPPPPPPPPPPPPPP
PPPPPPPPPPPPPPPPPPPPPPPPPPPPPP
PPPTTTTTTTTTTTTTTTTTTTTTTTTPPP
PPPTTTTTTTTTTTTTTTTTTTTTTTTPPP
PPPTTMTTMBBMTTMBBMTTMTTMTTTPPP
PPPTTMTTMBBMTTMBBMTTMTTMTTTPPP
PPPTTTTTTKDTTTTKDTTTTTTTTTTPPP
PPPMMTMMTMMTMMTMMTMMTMMTMMTPPP
PPPTTTTTTTTTTTTTTTTTTTTTTTTPPP
PPPAAMAAMTTMBBMAAMAAMAAMAAAPPP
PPPAAMAAMTTMBBMAAMAAMAAMAAAPPP
PPPAAMAAMTTMBBMAAMAAMAAMAAAPPP
PPPTTTTTTKDTTTTKDTTTTTTTTTTPPP
PPPMMTMMTMMTMMTMMTMMTMMTMMTPPP
PPPTTTTTTTTTTTTTTTTTTTTTTTTPPP
PPPBBMBBMBBMTTMBBMBBMBBMBBBPPP
PPPBBMBBMBBMTTMBBMBBMBBMBBBPPP
PPPBBMBBMBBMTTMBBMBBMBBMBBBPPP
PPPTTTTTTKDTTTTKDTTTTTTTTTTPPP
PPPMMTMMTMMTMMTMMTMMTMMTMMTPPP
PPPTTTTTTTTTTTTTTTTTTTTTTTTPPP
PPPTTMAAMAAMTTMAAMAAMTTMTTTPPP
PPPTTMAAMAAMTTMAAMAAMTTMTTTPPP
PPPTTMAAMAAMTTMAAMAAMTTMTTTPPP
PPPTTTTTTTTTTTTTTTTTTTTTTTTPPP
PPPTTTTTTTTTTTTTTTTTTTTTTTTPPP
PPPPPPPPPPPPPPPPPPPPPPPPPPPPPP
PPPPPPPPPPPPPPPPPPPPPPPPPPPPPP
PPPPPPPPPPPPPPPPPPPPPPPPPPPPPP
