30
30
MMMMMMMMMMMMMMMMMMMMMMMMMMMMMM
MMMMMMMMMMMMMMMMMMMMMMMMMMMMMM
MMMMMMMMMMMMMMMMMMMMMMMMMMMMMM
MMMAAAMTTTTTTTAABTTTTBBBBTTMMM
MMMAAAMTTTTTTAABBBTTBBBBTTBMMM
MMMAAAMTTTTTTAABBBBTTBBTTBBMMM
MMMMMMMTTTTTTTAABBBTTBTTBBBMMM
MMMTTTTTTTTTKTAABBTTBBTTBBBMMM
MMMTKTTTTTTTTTAABBBTTBTTBBKMMM
MMMTTTTTTTTTTAABBBTTTTTTBBBMMM
MMMTTTTDTTTTTAABBBDTTTTBBBBMMM
MMMTTTTTTTTTTAABBBTTBBTTBBBMMM
MMMTTTTTTTTTTAABBTTTTBTTBBBMMM
MMMTTTTTTTTTTTAABTTTTTTBBBTMMM
MMMTTTTTTTTTTTAABTTBTTBBBTTMMM
MMMTTTTTTTTTTTBAATTTTBTBTTBMMM
MMMTTTTTTTTTTTTTBTTBTTTTTBBMMM
MMMTTTTTMMMMMMMTTTBTTTBTBBBMMM
MMMTTTTTMTTTTTMTTBTTBBBBBBBMMM
MMMTTTTTMTTTTTMTTTTTTBBBBBBMMM
MMMTTTTTMTTTTTTTBTTTTTBBBBBMMM
MMMTTTTTMTTTTTMTBBTTBTTBBBBMMM
MMMTTTTTMTTTTTMTBTTBBTTBBBBMMM
MMMTTTTTMMMMMMMTBBTTBBTTBBBMMM
MMMTTTTTTTTTTTTTBBBTTBBTTBBMMM
MMMTTTTTTDBBBBBTTXBBTTBTTBBMMM
MMMTTTTTTTBBBBTTBBBBBBTTBBBMMM
MMMMMMMMMMMMMMMMMMMMMMMMMMMMMM
MMMMMMMMMMMMMMMMMMMMMMMMMMMMMM
MMMMMMMMMMMMMMMMMMMMMMMMMMMMMM
