30
30
PPPPPPPPPPPPPPPPPPPPPPPPPPPPPP
PPPPPPPPPPPPPPPPPPPPPPPPPPPPPP
PPPPPPPPPPPPPPPPPPPPPPPPPPPPPP
PPPAAAMTTTTTTTAABTTTTBBBBTTPPP
PPPAAAMTTTTTTAABBBTTBBBBTTBPPP
PPPAAAMTTTTTTAABBBBTTBBTTBBPPP
PPPMMMMTTTTTTTAABBBTTBTTBBBPPP
PPPTTTTTTTTTKTAABBTTBBTTBBBPPP
PPPTKTTTTTTTTTAABBBTTBTTBBKPPP
PPPTTTTTTTTTTAABBBTTTTTTBBBPPP
PPPTTTTDTTTTTAABBBDTTTTBBBBPPP
PPPTTTTTTTTTTAABBBTTBBTTBBBPPP
PPPTTTTTTTTTTAABBTTTTBTTBBBPPP
PPPTTTTTTTTTTTAABTTTTTTBBBTPPP
PPPTTTTTTTTTTTAABTTBTTBBBTTPPP
PPPTTTTTTTTTTTBAATTTTBTBTTBPPP
PPPTTTTTTTTTTTTTBTTBTTTTTBBPPP
PPPTTTTTMMMMMMMTTTBTTTBTBBBPPP
PPPTTTTTMTTTTTMTTBTTBBBBBBBPPP
PPPTTTTTMTTTTTMTTTTTTBBBBBBPPP
PPPTTTTTMTTTTTTTBTTTTTBBBBBPPP
PPPTTTTTMTTTTTMTBBTTBTTBBBBPPP
PPPTTTTTMTTTTTMTBTTBBTTBBBBPPP
PPPTTTTTMMMMMMMTBBTTBBTTBBBPPP
PPPTTTTTTTTTTTTTBBBTTBBTTBBPPP
PPPTTTTTTDBBBBBTTXBBTTBTTBBPPP
PPPTTTTTTTBBBBTTBBBBBBTTBBBPPP
PPPPPPPPPPPPPPPPPPPPPPPPPPPPPP
PPPPPPPPPPPPPPPPPPPPPPPPPPPPPP
PPPPPPPPPPPPPPPPPPPPPPPPPPPPPP