100
100
PPPPPPPPPPPPPPPPPPPPPPPPPPPPPPPPPPPPPPPPPPPPPPPPPPPPPPPPPPPPPPPPPPPPPPPPPPPPPPPPPPPPPPPPPPPPPPPPPPPP
PPPPPPPPPPPPPPPPPPPPPPPPPPPPPPPPPPPPPPPPPPPPPPPPPPPPPPPPPPPPPPPPPPPPPPPPPPPPPPPPPPPPPPPPPPPPPPPPPPPP
PPPPPPPPPPPPPPPPPPPPPPPPPPPPPPPPPPPPPPPPPPPPPPPPPPPPPPPPPPPPPPPPPPPPPPPPPPPPPPPPPPPPPPPPPPPPPPPPPPPP
PPPAAAAAAAAAAAAAAAAAAAAAAAAAAAAAAAAAAAAAAAAAAAAAAAAAAAAAAAAAAAAAAAAAAAAAAAAAAAAAAAAAAAMMMMMMMMMMMPPP
PPPAAAAAAAAAAAAAAAAAAAAAAAAAAAAAAAAAAAAAAAAAAAAAAAAAAAAAAAAAAAAAAAAAAAAAAAAAAAAAAAAAAMMMMMMMMMMMMPPP
PPPAAAAAAAAAAAAAAAAAAAAAAAAAAAAAAAAAAAAAAAAAAAAAAAAAAAAAAAAAAAAAAAAAAAAAAAAAAAAAAAAAMMMMMMMMMMMMMPPP
PPPAAAAAAAAAAAAAAAAAAAAAAAAAAAAAAAAAAAAAAAAAAAAAAAAAAAAAAAAAAAAAAAAAAAAAAAAAAAAAAAAAMMMMMMMMMMMMMPPP
PPPAAAAAAAAAAAAAAAAAAAAAAAAAAAAAAAAAAAAAAAAAAAAAAAAAAAAAAAAAAAAAAAAAAAAAAAAAAAAAAAAAMMMMMMMMMMMMMPPP
PPPAAAAAAAAAAAAAAAAAAAAAAAAAAAAAAAAAAAAAAAABBKBBAAAAAAAAAAAAAAAAAAAAAAAAAAAAAAAAAAAAMMMMMMMMMMMMMPPP
PPPAAAAAAAAAAAAAAAAAAAAAAAAAAAAAAAAAAAAATBABBBBBBAAAAASSAASAAAAAAAAAAAAAAAAAAAAAAAAMMMMMMMMMMMMMMPPP
PPPAAAAAAAAAAAAAAAAAAAATAAAAAAAAAAAAAATTTBBABABABBAASSSKSSSAAAASSSAAAAAAAAAAAAAAAAMMMMMMMMMMMMMMMPPP
PPPAAAAAAAAAAAAAAAAAATTTTAAAAAAAAAAASSSSBBBBABABABBBBSKKKKKKKKKSSSSBBAAAAAAAAAAAAAMMMMMMMMMMMMMMMPPP
PPPAAAAAAAAAAAAAAAAATTBTTTTTTTAAAAASSSKKKSSBBABABDDKKKKKKKKKKKKKSBBBAAAAAAAAAAAAAMMMMMMMMMMMMMMMMPPP
PPPAAAAAAAAAAAAAATTTTTTTTBTTTTTAASKKKKKKKKKSSBABDKKKKKKKKKKKKKKKAAAABTAAAAAAAAAAAMMMMMMMMMMMMMMMMPPP
PPPAAAAAAAAAAAAATTBTTTAATTTTTTTASKKKKKKKKKSSBBADKKKKKKKKKKKKKAAAKBBBTAAAAAAAAAAAAMMMMMMMMMMMMMMMMPPP
PPPAAAAAAAAAAAAATTTTTSSSSSTTTKKKKKKKKKKKKSSBBAXKKKKKKKKKKKKKAKKKSSBBTAAAAAAAAAAAAMMMMMMMMMMMMMMMMPPP
PPPAAAAAAAAAAAAATTBTTSSKSSTTKKKKKKKKKKKKAAAAABKKKKKKKKKKKKKKAKKKKKSBTAAAAAAAAAAAAMMMMMMMMMMMMMMMMPPP
PPPAAAAAAAAAATTTTTTTTTTTTTTTKKKKKKKKKKAAAKKKKKKKKAKKKKKKKKKKAKKKKKKSSAAAAAAAAAAAAMMMMMMMMMMMMMMMMPPP
PPPAAAAAAAAABBTTBTTTTTTTTTTTBBBBDDKKKKAKAKKKKKKKAKKKKKKKKKKKAKKKKKKBBSAAATSSTAAAAMMMMMMMMMMMMMMMMPPP
PPPAAAAAAABBBBTTTTTBTTTTTTTBBBBBBDDKKKAAAKKKKKKKKKKKKKKKKKKKAKKKKKKKKBSSAATTAAAAAAMMMMMMMMMMMMMMMPPP
PPPAAAAAAABBBBBBBTTTTTTTAATTTTBBBBDDKKAKKKKKKKKKKKKKKKKKKKKKAKKKKKKKKKBSSAAAAAAAAAAMMMMMMMMMMMMMMPPP
PPPAAAAAAABBBBBBBBAAAAAAAAAAAAAATBBBSKAKKKKKKKKKKKKKKKKKKKKKAKKKKKKKKKBBSAAAAAAATTAAMMMMMMMMMMMMMPPP
PPPAAAAAAABBBBBBBAAAABAAAABAAAAAAATBSKAKKKKKAKKAAKKKKXSSKKKKAKKKKKKKSSSSSAAAAAAAAAAAMMMMMMMMMMMMMPPP
PPPAAAAAAABBBBBBAAAAAAAAAAAAAAAAAAAASSAKKXKAAAAAAKKKKSSDKKKAKKKKKKKSSSSSSSBBBSSSSSAAMMMMMMMMMMMMMPPP
PPPAAAAAAABBBBBBAAAAAAAABBAAAAAAAAAAAABBBKKKKKKAKKKKKKKKKKKAKKKKKKKSSSSSBBBBBBBBBBSAAMMMMMMMMMMMMPPP
PPPAAAAAAAABBBBAAAAAAAAAKBBAAAAAABAAAABBSSKKKKKAAKKKKKKKKKKKKKKKKKKSSSBBBBBBBBBBABBBBMMMMMMMMMMMMPPP
PPPAAAAAAAAABBBAABBAAAAADBBBBBAAAAAAAABBBSKKKKKAKKKKKKKKKKKKKKKKKKKSSSSBBBBBBBBBAAABBMMMMMMMMMMMMPPP
PPPAAAAAAAAABBBAABBAAAAAAAABBBAAAAAAAAABBBKKBBASKKKKKKKKKKKKKKKKKKKSSSSBBBBBBBBBAABTTMMMMMMMMMMMMPPP
PPPAAAAAAAABBBBAAAAAAAAAAAAAAAAAAAAAAAAABBSBBABSSKKKKKKKKKKKKKKKKKKSSSSBBBBBTTBBTTTTMMMMMMMMMMMMMPPP
PPPAAAAAAABBBBBAAAAAAAAAAAAAAAAAAAAAAAAABBBBABBSSKKKKKKKKKKKKKKKKKKSSXBBBBTTTBBTTTBBMMMMMMMMMMMMMPPP
PPPAAAAAAABBBBBAAAAAAAAAAAABAAAAAAATAABABBBBABBBSKKKKKKKKXKKKKKKKKKSSSSBBTTTTBTTTTBBMMMMMMMMMMMMMPPP
PPPAAAAAAAABBBAAAAAAAAAAAABBAAAAAAABBBDAKDBABBBBKKKKKKKKKKKKKKKKKKSSSSSSBBTTTTTTTTTTMMMMMMMMMMMMMPPP
PPPAAAAAAAABBAAAAAAAAAAAAAABAAAAXBBBBBKADKBABBBSKKKKKKKKKKKKKKKKKKSSSSBBBBTTTTTTTXTTTMMMMMMMMMMMMPPP
PPPASAAAAAAABBAAAAAAAAAAAAAAAAABBBBBBBBAAAABBBBSKKKKKKKKKKKKKKKKKSSSSSSBBTTTTTTTTTTTBTTBBMMMMMMMMPPP
PPPAAAAAAAABBBABBBAAAAAAAAAABBBBBBBBBAAAKDBBBBSSKKKKKKKKKKKKKKKKKSSSSSSSBBTTTTTTTTTBBBBBBBMMMMMMMPPP
PPPAAATAAAABBBAAAAAAABBBBBBBBBBBBBAAAABBBBBBBBSKKKKKKKKKKKKKKKKKSSSBBSSSSSTTTTAKTTTBABTBBMMMMMMMMPPP
PPPAAATTAAABBBBAAAAABBBBBBBBBBBAAAABBBBBBBBBBSSSKKKKKKKKKKKKKKKSSSBBBBBBSSBTTTTTBTTBSTTBBMMMMMMMMPPP
PPPAAAAAAAABBBBDKDKBBBBBBBTBBBAABBBBBBBBBBBBBBSSKKKKSSKKKKKKKKSSBBBABBBSSSSSBBSSBBBBBTBBMMMMMMMMMPPP
PPPAAAAAAAAAAAAAAAAAAAAAAAAAAAABBBBBBBBBBBBBBBBBBBBSSBSKKKKKKAABBBBBBBSSSSBBABSSSSBBBBBBMMMMMMMMMPPP
PPPSSAAAAAABBBBKDKDBBBBBBBBBBBABBBBBBBBBBBBBBBBBBBSBBBSKKKKSSSSAAABBBSSSSSSSSBBBSSSSSSBBBMMMMMMMMPPP
PPPSAAAAAAAATTBBBBBBSSSSSSSSBBABBBBBBBBBBBBBBBBBBSBBBBBSKKSSSBBBBBAAATTASSSSSSSSSSSSSSSSSSMMMMMMMPPP
PPPSAAAAAAAAATBBBBBBSBBBBBSSSBABBBBBBBBBBBBBBBBBSBBBBBBBSSSSBBBBBBBBTTTTAATAAAAAAASSSSSSSBBBMMMMAPPP
PPPSAAAAAAAAATBBBBBBSBBBBSBBSSASSSSSSSXSSBBBBBSSBBBBBBBSSSSBBBSBBBBXTTTTTTATTTTTTAAASSSSBBTBBMMAAPPP
PPPAAAAAAKBBXBBBBBBBSBBBBBBBBBABBBBBBBDSSXSSSSSBSBBBSBBBBSSSBBSBBBBTSTTTTTTTTTTTTTTAAAAAAABBMAAAAPPP
PPPAAAAADSSBBBBBBBBSTTTTSTTSBBABBBBBBBBBBBBBBBBSSBBSXBBBBBBSBBBBBBTTTSTTTTTTSSSTTTTTTTTTTTAAAAAAAPPP
PPPAAAAAASSBBBBBBBSSSSTTSTTTSBABBBBBBBBBBBBSBSMMMSSBBBSBBBBBSBBBBTTTTTSSTTTTSSSTTSTTTSSTTTAAAAAAAPPP
PPPAAAAAAAAASTTTTTTTTTTTTTTTXAAKBBBBBBBBSSMXMMMPMMMSSSSSBBSBBBBTTTTTTTSSTTTTSSSTTSTTTSSTTAAAAAAAAPPP
PPPAAAAAAATTTTTTTTTTTTTTTTTTASSDBBBBBBBSSSMPPPPPPPMMMMSSSBBBBBBTTTTTTTTTTTTTTTTTSSBBTTTAAAAAAAAAAPPP
PPPAAAAAATTTTTTTTTTTTTTSSTTTASSABBBBBBBSSMMPPPPPPPPPPMMSSSBBBBTTXTTTTTTAATSTTTTTSBBBBBBAAAAAAAAAAPPP
PPPASAAATTTTTTTSSTTTTTTSSTTBASSABBBBBBBSMMPPPPPPPPPPPPMMSSBBXSSSSTTSSSSSSSSSSTTSSBBBBBBAAAAAAAAAAPPP
PPPASAAATTTTTTTTTTTTTTTTTTBBDXABBBBBBBSSMPPPPPPPPPPPPPPMMSBBBSSDSTTTTTTTTTTTTTTSAXSSBBBKAAAAAAAAAPPP
PPPSAAATTTSTTTTTTSSSTTTTTBBBBBBABBBBBSSMMPPPPPPPPPPPPPPPMSSBBBBBTTTTTTAATTTTTTTSASSDAAAAAAAAAAAAAPPP
PPPAAAASTTTTTTTTTTTTTTSBBBBBBBBBAAASSSMMPPPPPPPPPPPPPPPPMSSBBBBBBBAAABAAATTKDTAAAASAASAAAAAAAAAAAPPP
PPPAAAAABBTTBBTTTTTTTSBBBBBBBBBBBBBSSMMPPPPPPPPPPPPPPPPPMSSBBBBBBBBAAAAAAAAAABBAASSSSSAAAAAAAAAAAPPP
PPPAAAASSBBBBBBTTTTTSBBBBBSBBBBBBBBSMMPPPPPPPPPPPPPPPPPPMMSSBBBBBBBABBBAAAAAABBSAASAASAAAAAAAAAAAPPP
PPPAAASSBBBBBBBBBBBBBBBBBBBBBBBBBBSSMPPPPPPPPPPXPPPPPPPPPMSSBBBBBBBBABBBBBBDKBBBSSSKAAAAAAAAAAAAAPPP
PPPAAASBBBBBBBBBBBBBXBBBBBBBBBBBBBSSMPPPPPPPPPPPPPPPPPPPPMSSBBBBBBBBABBBBBBBBBBBSXAAAAAAAAAAAAAAAPPP
PPPAAASBBBBBSSBSSSSBBBBBBBBBBBBSBBSSMPPPPPPPPPPPPPPPPPPPMMSSBBBBBBBBBABBBBBBBBBBAASSAASSAAAAAAAAAPPP
PPPAASSBBSSBBSBBBBBBBBBBBBBBBBBBBBSSMPPPPPPPPPPPPPPPPPPPMSSSBBBBBBBBBABBBBBBBBAASBSSAASSAAAAAAAAAPPP
PPPAASSBBSSBBSBBBBBSSBBBBBBBBBBBBSSSMMPPPPPPPPPPPPPPPPPPMMSSBBBBBBBBBBAABBBKDAASBBSSASAAAAAABBAAAPPP
PPPAASSBBSSAAASSBBBBBBSBBBBBBBSBBBSSSMMMPPPPPPPPPPPPPPPPPMSSBBBBBBBBBBAAAAAAADKBBBAASSSAAAAABBBAAPPP
PPPAASSKBBSATABBBBBSSSSBBBBBBSBBBBBSSSSMMPPPPPPPPPPPPPPPPMSSBBBBBBBBBBBAXSSSSBBBAABBBBBBAAAAASAAAPPP
PPPAASSBBBSAAABBBBSSBSSSSSSBBSBBBBBSSKDSMMPPPPPPPPPPPPPPPMSSBBBBBBBBBBBBASBBBBBAABBBBBBBBAAAAAAAAPPP
PPPAAASBBBBBBBABSKDAAAAABSSSSAABKDBSSSXSSMMPPPPPPPPPPPPPPMSSBBBBBBBBBBBBBAABKDAABBBBBBBBBSAAAAAAAPPP
PPPAAASSBBBBBBSAAAAABSBBAAAAABBAAAAAASBBBSMMMMPPPPPPPPPPPMSSBBBBBBBBBBBBBSBAAAABBBBBBBBBBSAAAAAAAPPP
PPPAAASSBBBBBBBBBDKBABBBBBBBBBBBDKSSSASSBSSSSMMMMMPPPPPPPMSSBBBBSBSBBBBBBSBBDKBBBBBBBBBBBBAAAAAAAPPP
PPPAAAAASSBBBBBBXBBBBABBBBBBBBBSSSSSSASSSBBSSMMMMMMMMMPPMMSSTTSSSSSSSBBBBSBBBBBBBBBBBBBBBAAAAAAAAPPP
PPPAAAAAASSBBBBBBBBBBABBBBBBBSSSSSSTTSAASSBBSMSSSSMSSMMMMSSSTTTSSTSSSSBBBSBBBBBBBBBBBBBBAAAAAAAAAPPP
PPPAAAAAAASBBBBBBBSSSABBBBSSSSSSSSSTTTSSAAAAAMSKDSMBBASSSSSSSTTSSTTTSSSSSBBBBBBBBBBBBBBSAAAAAAAAAPPP
PPPAAAAAAAASSBBBBBBSSSABBSSTSSSSSSSTTTSSAAAAAMSDKBMBBATTTSSSSTTSSTTTTTSSBBDBBBBBBBBBBSAAAAAAAAAAAPPP
PPPAAAAAAAAAASBBBBBBBBABBSSTSTSTSTSSTTSSSAAAMMSSSSMMAASSTTTTTTTSSSSSSSSXSSSSSXBBBBBBBAAAAAAAAAAAAPPP
PPPAAAAAAAAAASBBBBBSSBABSSSSTSTSTSTSSSSSSBAMMXSSSSSMMAASSTTTTSSSTTTTSSSSSASBBBBBBBBBSAAAAAAAAAAAAPPP
PPPAAAAAAAAAASBBBBBBSBASSSSBDBXTSTSSSSSSSSAMSSBKDSSXMSASSSSSSSSSSSSSSSSSBBBBBBBBBSBSAAAAAAAAAAAAAPPP
PPPAAAAAAAAAAAABBBBBBBBASSXBBBTSTSTSSSSSSSSSSSBDKSSSSSSSSSTTSSSSSSSSTTTSBBBBBSSSAAAAAAAAAAAAAAAAAPPP
PPPAAAAAAAAAAAASBBBBBBSSASTTSTSTSSSXSSSSSBAAMMMSSMMMAAATTTTTSSSSSSTTTTTTBBBBBSAAAAAAAAAAAAAAAAAAAPPP
PPPAAAAAAAAAAASSBBBBBSSSSAASSSBSSSSSSSSBBBBAAAMSSMAAAASSSSSSSTTTSSTSSSSSSSBBAAAAAAAAAAAAAAAAAAAAAPPP
PPPAAAAAAAAAASSSSSBBSSSSSSSASSBBDKDKSSSBBAAAAAMSSMAAABAABBSBSTTTSTTSSSSSSSSSAAAAAAAAAAAAAAAAAAAAAPPP
PPPAAAAAAAAAASBBBBSBSSSSSSSBAAAAAAAAAAAAABBBBAASSXBBBBBBASSKDSSSSTTSSSSSSSSAAAAAAAAAAAAAAAAAAAAAAPPP
PPPAAAAAAAAAASBBBBBSSSSSSSSBBBBBKDKDBBBBBBBBBBBBBBBBBBBBBAAAAASSTTTSSSSSSSSAAAAAAAAAAAAAAAAAAAAAAPPP
PPPAAAAAAAAAASBBBBBASSSSSSBBBBBBBBBBBBBSSBBBBBBBBBBBBBBBBBBDKBAATTTTTSSSSSAAAAAAAAAAAAAAAAAAAAAAAPPP
PPPAAAAAAAAASBBBBSSBSSSSSSSBBBBBBBBBBBBBBBBBBBBBBBBBBBBBBBBBBBBAATTTTSSSSSAAAAAAAAAAAAAAAAAAAAAAAPPP
PPPAAAAAAAASSBBBBSSSSSBABSSBBBBSBBBBBBBBBBBBBBBBBBBBBBBBBBBBBBBBBAAAAAAASSAAAAAAAAAAAAAAAAAAAAAAAPPP
PPPAAAAAAAASSBBSSSSSSSSBSAAABBBSBBBBBBBBSSSBBBBSSSSBBBBBBBBBBBBBBAAABBBSAAAAAAAAAAAAAAAAAAAAAAAAAPPP
PPPAAAAAAAASSSBBSSBBBBBBBSBBABBBSBBBBBBSBSSSBBBDSSXBBBABBBBBAABBBAAAABBSAAAAAAAAAAAAAAAAAAAAAAAAAPPP
PPPAAAAAAAASSSSMMMSBBBBBBSBBAABBBBBBBBBSBBSBSBBBBBBBBBBBBBAABABBBBBBBSAAAAAAAAAAAAAAAAAAAAAAAAAAAPPP
PPPAAAAAAAASMXMMDMSSSSBBBSBBBABBABBBBBSSBBBBSBBBBBBBBBBBBABABBBABBBBXAAAAAAAAAAAAAAAAAAAAAAAAAAAAPPP
PPPAAAAAAAASMMMSSSSSBBBBSBBBBABBBBBBBBBBBBBBBBBBBBBBBBBBBAAABBBBBBBAAAAAAAAAAAAAAAAAAAAAAAAAAAAAAPPP
PPPAAAAAAAASSSSSSSSBBBSSSBBBBAABBBBBBBBBBBBBBBBBBBBBKBBBBBAABBBKBAAAAAAAAAAAAAAAAAAAAAAAAAAAAAAAAPPP
PPPAAAAAAAAAASSSSSSSSSSSAAAAAAAAAAAAABBBBBBBBBBBBBBTAAABBBBBBBBBBAAAAAAAAAAAAAAAAAAAAAAAAAAAAAAAAPPP
PPPAAAAAAAAAAAAAAASSSSSSAAAAAAAAAAAAAABBBBBAABBBBBBBAAAAAAAABBBAAAAAAAAAAAAAAAAAAAAAAAAAAAAAAAAAAPPP
PPPAAAAAAAAAAAAAAAAAAAAAAAAAAAAAAAAAAAAAAAAAABBBBBTTAAAAAAAAAAAAAAAAAAAAAAAAAAAAAAAAAAAAAAAAAAAAAPPP
PPPAAAAAAAAAAAAAAAAAAAAAAAAAAAAAAAAAAAAAAAAAAXBBBDTAAAAAAAAAAAAAAAATTAAAAAAAAAAAAAAAAAAAAAAAAAAAAPPP
PPPAAAAAAAAAAAAAAAAAAAAAAAAAAAAAAAAAAAAAAAAAAAAAABTAAAAAAAAAAAAAAAAAAAAAAAAAAAAAAAAAAAAAAAAAAAAAAPPP
PPPAAAAAAAAAAAAAAAAAAAAAAAAAAAAAAAAAAAAAAAAAAAAAAAAAAAAAAAAAAAAAAAAAAAAAAAAAAAAAAAAAAAAAAAAAAAAAAPPP
PPPAAAAAAAAAAAAAAAAAAAAAAAAAAAAAAAAAAAAAAAAAAAAAAAAAAAAAAAAAAAAAAAAAAAAAAAAAAAAAAAAAAAAAAAAAAAAAAPPP
PPPAAAAAAAAAAAAAAAAAAAAAAAAAAAAAAAAAAAAAAAAAAAAAAAAAAAAAAAAAAAAAAAAAAAAAAAAAAAAAAAAAAAAAAAAAAAAAAPPP
PPPAAAAAAAAAAAAAAAAAAAAAAAAAAAAAAAAAAAAAAAAAAAAAAAAAAAAAAAAAAAAAAAAAAAAAAAAAAAAAAAAAAAAAAAAAAAAAAPPP
PPPPPPPPPPPPPPPPPPPPPPPPPPPPPPPPPPPPPPPPPPPPPPPPPPPPPPPPPPPPPPPPPPPPPPPPPPPPPPPPPPPPPPPPPPPPPPPPPPPP
PPPPPPPPPPPPPPPPPPPPPPPPPPPPPPPPPPPPPPPPPPPPPPPPPPPPPPPPPPPPPPPPPPPPPPPPPPPPPPPPPPPPPPPPPPPPPPPPPPPP
PPPPPPPPPPPPPPPPPPPPPPPPPPPPPPPPPPPPPPPPPPPPPPPPPPPPPPPPPPPPPPPPPPPPPPPPPPPPPPPPPPPPPPPPPPPPPPPPPPPP
