30
30
PPPPPPPPPPPPPPPPPPPPPPPPPPPPPP
PPPPPPPPPPPPPPPPPPPPPPPPPPPPPP
PPPPPPPPPPPPPPPPPPPPPPPPPPPPPP
PPPTTTTTTTTTTTTTTTTTTTTTTTTPPP
PPPTTTTTTTTTTTTTTTTTTTTTTTTPPP
PPPTTMTTMTTMTTMTTMTTMTTMTTTPPP
PPPTTMTTMTTMTTMTTMTTMTTMTTTPPP
PPPTTTTTTTTTTTTTTTTTTTTTTTTPPP
PPPMMTMMTMMTMMTMMTMMTMMTMMTPPP
PPPTTTTTTTTTTTTTTTTTTTTTTTTPPP
PPPTTMTTMTTMTTMTTMTTMTTMTTTPPP
PPPTTMTTMTTMTTMTTMTTMTTMTTTPPP
PPPTTMTTMTTMTTMTTMTTMTTMTTTPPP
PPPTTTTTTTTTTTTTTTTTTTTTTTTPPP
PPPMMTMMTMMTMMTMMTMMTMMTMMTPPP
PPPTTTTTTTTTTTTTTTTTTTTTTTTPPP
PPPTTMTTMTTMTTMTTMTTMTTMTTTPPP
PPPTTMTTMTTMTTMTTMTTMTTMTTTPPP
PPPTTMTTMTTMTTMTTMTTMTTMTTTPPP
PPPTTTTTTTTTTTTTTTTTTTTTTTTPPP
PPPMMTMMTMMTMMTMMTMMTMMTMMTPPP
PPPTTTTTTTTTTTTTTTTTTTTTTTTPPP
PPPTTMTTMTTMTTMTTMTTMTTMTTTPPP
PPPTTMTTMTTMTTMTTMTTMTTMTTTPPP
PPPTTMTTMTTMTTMTTMTTMTTMTTTPPP
PPPTTTTTTTTTTTTTTTTTTTTTTTTPPP
PPPTTTTTTTTTTTTTTTTTTTTTTTTPPP
PPPPPPPPPPPPPPPPPPPPPPPPPPPPPP
PPPPPPPPPPPPPPPPPPPPPPPPPPPPPP
PPPPPPPPPPPPPPPPPPPPPPPPPPPPPP
