100
100
PPPPPPPPPPPPPPPPPPPPPPPPPPPPPPPPPPPPPPPPPPPPPPPPPPPPPPPPPPPPPPPPPPPPPPPPPPPPPPPPPPPPPPPPPPPPPPPPPPPP
PPPPPPPPPPPPPPPPPPPPPPPPPPPPPPPPPPPPPPPPPPPPPPPPPPPPPPPPPPPPPPPPPPPPPPPPPPPPPPPPPPPPPPPPPPPPPPPPPPPP
PPPPPPPPPPPPPPPPPPPPPPPPPPPPPPPPPPPPPPPPPPPPPPPPPPPPPPPPPPPPPPPPPPPPPPPPPPPPPPPPPPPPPPPPPPPPPPPPPPPP
PPPTTTTTTTTTTTTTTTTTTTTTTTTTTTTTTTTTTTTTTTTTTTTTTTTTTTTTTTTTTTTTTTTTTTTTTTTTTTTTTTTTTTTTTTTTTTTTTPPP
PPPTTTTTTTTTTTTTTTTTTTTTTTTTTTTTTTTTTTTTTTTTTTTTTTTTTTTTTTTTTTTTTTTTTTTTTTTTTTTTTTTTTTTTTTTTTTTTTPPP
PPPTTTTTTTTTMMMMMMMMMMTTTTTTTTTTTTTTTTTTTTTMMMMMMMMMMTTTTTTTTMMMMMMMMMMMMMMMMMMMMMMMTTTTTTTTTTTTTPPP
PPPTTTTTTTTTMTTTTTTTTMTTTTTTTTTTTTTTTTTTTTTMTTTTTTTTMTTTTTTTTMTTTTTTTTTTTTTTTTTTTTTTTTTTTTTTTTTTTPPP
PPPTTTTTTTTTMTTTTTTTTMTTTTTTTTTTTTTTTTTTTTTMTTTTTTTTMTTTTTTTTMMTMMMMMMMMMMMMMMMMMMMMTTTTTTTTTTTTTPPP
PPPTTTTTTTTTMTTTTTTTTMMMTTTTTTTTTTTTTTTTTTTMTTTTTTTTMTTTTTTTTMTTTTTTTTTTTTTTTTTTTTTMTTTTTTTTTTTTTPPP
PPPTTTTTTTKTMTTTTTTTTTTMMTTTTTTTTTTTTTTTTTTMTTTTTTTTMTTTTTTTTMTTTTTTTTTTTTTTTTTTTTTMTTTTTTTTTTTTTPPP
PPPTTTTTTTTTMTTTTTTTTTTTMMTTTTTTTTTTTTTTTTTMTTTTTTTTMTTTTTTTTMTTTTTTTTTTTTTTTTTTTTTMTTTTTTTTTTTTTPPP
PPPTTTTTTTTTMTTTTTXTTTTTTMTTTTTTTTTTTTTTTTTTTTTTXTTTTTTTTTTTTMTTTTTTTTTTTXTTTTTTTTTMTTTTTTTTTTTTTPPP
PPPTTTTTTTTTTTTTTTTTTTTTTMTTTTTTTTTTTTTTTTTMTTTTTTTTMTTTTTTTTMTTTTTTTTTTTTTTTTTTTTTMTTTTTTTTTTTTTPPP
PPPTTTTTTTTTMTTTTTTTTTTTTMTTTTTTTTTTTTTTTTTMTTTTTTTTMTTTTTTTTMTTTTTTTTTTTTTTTTTTTTTMTTTTTTTTTTTTTPPP
PPPTTTTTTTTTMTTTTTTTTTTTTMTTTTTTTTTTTTTTTTTMTTTTTTTTMTTTTTTTTMMMMMMMMMMMMMMMMMMMMMTMTTTTTTTTTTTTTPPP
PPPTTTTTTTTTMTTTTTTTTTTTTMTTTTTTTTTTTTTTTTTMTTTTTTTTMTTTTTTTTTTTTTTTTTTTTTTTTTTTTTTMTTTTTTTTTTTTTPPP
PPPTTTTTTTTTMMMMMMMMMMMMMMTTTTTTTTTTTTTTTTTMMMMMMMMMMTTTTTTTTMMMMMMMMMMMMMMMMMMMMMMMTTTTTTTTTTTTTPPP
PPPTTTTTTTTTTTTTTTTTTTTTTTTTTTTTTTTTTTTTTTTTTTTTTTTTTTTTTTTTTTTTTTTTTTTTTTTTTTTTTTTTTTTTTTTTTTTTTPPP
PPPTTTTTTTTTTTTTTTTTTTTTTTTTTTTTTTTTTTTTTTTTTTTTTTTTTTTTTTTTTTTTTTTTTTTTTTTTTTTTTTTTTTTTTTTTTTTTTPPP
PPPPPPPPPPPTTTPPPPPPPPPPPPPPPPPPPPPPPPPPPPPPPPPPPPPPPPPPPPPPPPPPPPPPPPPPPPPPPPPPPPPPPPPPPPPPPPPPPPPP
PPPTTTTTTTTTTTTTTTTTTTTTTTTTTTTTTTTTTTTTTTTTTTTTTTTTTTTTTTTTTTTTTTTTTTTTTTTTTTTTTTTTTTTTTTTTTTTTTPPP
PPPTTTTTTTTTTTTTTTTTTTTTTTTTTTTTTTTTTTTTTTTTTTTTTTTTTTTTTTTTTTTTTTTTTTTTTTTTTTTTTTTTTTTTTTTTTTTTTPPP
PPPTTTTTTTTTMMMMMMMMMMTTTTTTTTTTTTTTTTTTTTTMMMMMMMMMMTTTTTTTTMMMMMMMMMMMMMMMMMMMMMMMTTTTTTTTTTTTTPPP
PPPTTTTTTTTTMTTTTTTTTMTTTTTTTTTTTTTTTTTTTTTMTTTTTTTTMTTTTTTTTMTTTTTTTTTTTTTTTTTTTTTTTTTTTTTTTTTTTPPP
PPPTTTTTTTTTMTTTTTTTTMTTTTTTTTTTTTTTTTTTTTTMTTTTTTTTMTTTTTTTTMMTMMMMMMMMMMMMMMMMMMMMTTTTTTTTTTTTTPPP
PPPTTTTTTTTTMTTTTTTTTMMMTTTTTTTTTTTTTTTTTTTMTTTTTTTTMTTTTTTTTMTTTTTTTTTTTTTTTTTTTTTMTTTTTTTTTTTTTPPP
PPPTTTTTTTKTMTTTTTTTTTTMMTTTTTTTTTTTTTTTTTTMTTTTTTTTMTTTTTTTTMTTTTTTTTTTTTTTTTTTTTTMTTTTTTTTTTTTTPPP
PPPTTTTTTTTTMTTTTTTTTTTTMMTTTTTTTTTTTTTTTTTMTTTTTTTTMTTTTTTTTMTTTTTTTTTTTTTTTTTTTTTMTTTTTTTTTTTTTPPP
PPPTTTTTTTTTMTTTTXTTTTTTTMTTTTTTTTTTTTTTTTTTTTTTXTTTTTTTTTTTTMTTTTTTTTTTTTXTTTTTTTTMTTTTTTTTTTTTTPPP
PPPTTTTTTTTTTTTTTTTTTTTTTMTTTTTTTTTTTTTTTTTMTTTTTTTTMTTTTTTTTMTTTTTTTTTTTTTTTTTTTTTMTTTTTTTTTTTTTPPP
PPPTTTTTTTTTMTTTTTTTTTTTTMTTTTTTTTTTTTTTTTTMTTTTTTTTMTTTTTTTTMTTTTTTTTTTTTTTTTTTTTTMTTTTTTTTTTTTTPPP
PPPTTTTTTTTTMTTTTTTTTTTTTMTTTTTTTTTTTTTTTTTMTTTTTTTTMTTTTTTTTMMMMMMMMMMMMMMMMMMMMMTMTTTTTTTTTTTTTPPP
PPPTTTTTTTTTMTTTTTTTTTTTTMTTTTTTTTTTTTTTTTTMTTTTTTTTMTTTTTTTTTTTTTTTTTTTTTTTTTTTTTTMTTTTTTTTTTTTTPPP
PPPTTTTTTTTTMMMMMMMMMMMMMMTTTTTTTTTTTTTTTTTMMMMMMMMMMTTTTTTTTMMMMMMMMMMMMMMMMMMMMMMMTTTTTTTTTTTTTPPP
PPPTTTTTTTTTTTTTTTTTTTTTTTTTTTTTTTTTTTTTTTTTTTTTTTTTTTTTTTTTTTTTTTTTTTTTTTTTTTTTTTTTTTTTTTTTTTTTTPPP
PPPTTTTTTTTTTTTTTTTTTTTTTTTTTTTTTTTTTTTTTTTTTTTTTTTTTTTTTTTTTTTTTTTTTTTTTTTTTTTTTTTTTTTTTTTTTTTTTPPP
PPPTTTTTTTTTTTTTTTTTTTTTTTTTTTTTTTTTTTTTTTTTTTTTTTTTTTTTTTTTTTTTTTTTTTTTTTTTTTTTTTTTTTTTTTTTTTTTTPPP
PPPPPPPPPPPPPPPPPPPPPPPPPPPPPPPPPPPPPPPPPPPPPPPPPPPPPPPPPPPPPTTTPPPPPPPPPPPPPPPPPPPPPPPPPPPPPPPPPPPP
PPPTTTTTTTTTTTTTTTTTTTTTTTTTTTTTTTTTTTTTTTTTTTTTTTTTTTTTTTTTTTTTTTTTTTTTTTTTTTTTTTTTTTTTTTTTTTTTTPPP
PPPTTTTTTTTTMMMMMMMMMMTTTTTTTTTTTTTTTTTTTTTMMMMMMMMMMTTTTTTTTMMMMMMMMMMMMMMMMMMMMMMMTTTTTTTTTTTTTPPP
PPPTTTTTTTTTMTTTTTTTTMTTTTTTTTTTTTTTTTTTTTTMTTTTTTTTMTTTTTTTTMTTTTTTTTTTTTTTTTTTTTTTTTTTTTTTTTTTTPPP
PPPTTTTTTTTTMTTTTTTTTMTTTTTTTTTTTTTTTTTTTTTMTTTTTTTTMTTTTTTTTMMTMMMMMMMMMMMMMMMMMMMMTTTTTTTTTTTTTPPP
PPPTTTTTTTTTMTTTTTTTTMMMTTTTTTTTTTTTTTTTTTTMTTTTTTTTMTTTTTTTTMTTTTTTTTTTTTTTTTTTTTTMTTTTTTTTTTTTTPPP
PPPTTTTTTTKTMTTTTTTTTTTMMTTTTTTTTTTTTTTTTTTMTTTTTTTTMTTTTTTTTMTTTTTTTTTTTTTTTTTTTTTMTTTTTTTTTTTTTPPP
PPPTTTTTTTTTMTTTTTTTTTTTMMTTTTTTTTTTTTTTTTTMTTTTTTTTMTTTTTTTTMTTTTTTTTTTTTTTTTTTTTTMTTTTTTTTTTTTTPPP
PPPTTTTTTTTTMTTTTTXTTTTTTMTTTTTTTTTTTTTTTTTTTTTTXTTTTTTTTTTTTMTTTTTTTTTTTTXTTTTTTTTMTTTTTTTTTTTTTPPP
PPPTTTTTTTTTTTTTTTTTTTTTTMTTTTTTTTTTTTTTTTTMTTTTTTTTMTTTTTTTTMTTTTTTTTTTTTTTTTTTTTTMTTTTTTTTTTTTTPPP
PPPTTTTTTTTTMTTTTTTTTTTTTMTTTTTTTTTTTTTTTTTMTTTTTTTTMTTTTTTTTMTTTTTTTTTTTTTTTTTTTTTMTTTTTTTTTTTTTPPP
PPPTTTTTTTTTMTTTTTTTTTTTTMTTTTTTTTTTTTTTTTTMTTTTTTTTMTTTTTTTTMMMMMMMMMMMMMMMMMMMMMTMTTTTTTTTTTTTTPPP
PPPTTTTTTTTTMTTTTTTTTTTTTMTTTTTTTTTTTTTTTTTMTTTTTTTTMTTTTTTTTTTTTTTTTTTTTTTTTTTTTTTMTTTTTTTTTTTTTPPP
PPPTTTTTTTTTMMMMMMMMMMMMMMTTTTTTTTTTTTTTTTTMMMMMMMMMMTTTTTTTTMMMMMMMMMMMMMMMMMMMMMMMTTTTTTTTTTTTTPPP
PPPTTTTTTTTTTTTTTTTTTTTTTTTTTTTTTTTTTTTTTTTTTTTTTTTTTTTTTTTTTTTTTTTTTTTTTTTTTTTTTTTTTTTTTTTTTTTTTPPP
PPPPPPPPPPPPPPPPPPPPPPPPPPPPPPPPPPPPPPPPPPPPPPPPPPPPPPPPPPPPPTTTPPPPPPPPPPPPPPPPPPPPPPPPPPPPPPPPPPPP
PPPTTTTTTTTTTTTTTTTTTTTTTTTTTTTTTTTTTTTTTTTTTTTTTTTTTTTTTTTTTTTTTTTTTTTTTTTTTTTTTTTTTTTTTTTTTTTTTPPP
PPPTTTTTTTTTMMMMMMMMMMTTTTTTTTTTTTTTTTTTTTTMMMMMMMMMMTTTTTTTTMMMMMMMMMMMMMMMMMMMMMMMTTTTTTTTTTTTTPPP
PPPTTTTTTTTTMTTTTTTTTMTTTTTTTTTTTTTTTTTTTTTMTTTTTTTTMTTTTTTTTMTTTTTTTTTTTTTTTTTTTTTTTTTTTTTTTTTTTPPP
PPPTTTTTTTTTMTTTTTTTTMTTTTTTTTTTTTTTTTTTTTTMTTTXTTTTMTTTTTTTTMMTMMMMMMMMMMMMMMMMMMMMTTTTTTTTTTTTTPPP
PPPTTTTTTTTTMTTTTTTTTMMMTTTTTTTTTTTTTTTTTTTMTTTTTTTTMTTTTTTTTMTTTTTTTTTTTTTTTTTTTTTMTTTTTTTTTTTTTPPP
PPPTTTTTTTKTMTTTTTTTTTTMMTTTTTTTTTTTTTTTTTTMTTTTTTTTMTTTTTTTTMTTTTTTTTTTTTTTTTTTTTTMTTTTTTTTTTTTTPPP
PPPTTTTTTTTTMTTTTTTTTTTTMMTTTTTTTTTTTTTTTTTMTTTTTTTTMTTTTTTTTMTTTTTTTTTTXTTTTTTTTTTMTTTTTTTTTTTTTPPP
PPPTTTTTTTTTMTTTTTTTTTTTTMTTTTTTTTTTTTTTTTTTTTTTTTTTTTTTTTTTTMTTTTTTTTTTTTTTTTTTTTTMTTTTTTTTTTTTTPPP
PPPTTTTTTTTTTTTTTTTTTTTTTMTTTTTTTTTTTTTTTTTMTTTTTTTTMTTTTTTTTMTTTTTTTTTTTTTTTTTTTTTMTTTTTTTTTTTTTPPP
PPPTTTTTTTTTMTTTTTTTTTTTTMTTTTTTTTTTTTTTTTTMTTTTTTTTMTTTTTTTTMTTTTTTTTTTTTTTTTTTTTTMTTTTTTTTTTTTTPPP
PPPTTTTTTTTTMTTTTTXTTTTTTMTTTTTTTTTTTTTTTTTMTTTTTTTTMTTTTTTTTMMMMMMMMMMMMMMMMMMMMMTMTTTTTTTTTTTTTPPP
PPPTTTTTTTTTMTTTTTTTTTTTTMTTTTTTTTTTTTTTTTTMTTTTTTTTMTTTTTTTTTTTTTTTTTTTTTTTTTTTTTTMTTTTTTTTTTTTTPPP
PPPTTTTTTTTTMMMMMMMMMMMMMMTTTTTTTTTTTTTTTTTMMMMMMMMMMTTTTTTTTMMMMMMMMMMMMMMMMMMMMMMMTTTTTTTTTTTTTPPP
PPPTTTTTTTTTTTTTTTTTTTTTTTTTTTTTTTTTTTTTTTTTTTTTTTTTTTTTTTTTTTTTTTTTTTTTTTTTTTTTTTTTTTTTTTTTTTTTTPPP
PPPPPPPPPPPPPPPPPPPPPPPPPPPPPPPPPPPPPPPPPPPPPPPPPPPPPPPPPPPPPTTTPPPPPPPPPPPPPPPPPPPPPPPPPPPPPPPPPPPP
PPPTTTTTTTTTTTTTTTTTTTTTTTTTTTTTTTTTTTTTTTTTTTTTTTTTTTTTTTTTTTTTTTTTTTTTTTTTTTTTTTTTTTTTTTTTTTTTTPPP
PPPTTTTTTTTTMMMMMMMMMMTTTTTTTTTTTTTTTTTTTTTMMMMMMMMMMTTTTTTTTMMMMMMMMMMMMMMMMMMMMMMMTTTTTTTTTTTTTPPP
PPPTTTTTTTTTMTTTTTTTTMTTTTTTTTTTTTTTTTTTTTTMTTTTTTTTMTTTTTTTTMTTTTTTTTTTTTTTTTTTTTTTTTTTTTTTTTTTTPPP
PPPTTTTTTTTTMTTTTTTTTMTTTTTTTTTTTTTTTTTTTTTMTTTTTTTTMTTTTTTTTMMTMMMMMMMMMMMMMMMMMMMMTTTTTTTTTTTTTPPP
PPPTTTTTTTTTMTTTTTTTTMMMTTTTTTTTTTTTTTTTTTTMTTTTTTTTMTTTTTTTTMTTTTTTTTTTTTTTTTTTTTTMTTTTTTTTTTTTTPPP
PPPTTTTTTTKTMTTTTTTTTTTMMTTTTTTTTTTTTTTTTTTMTTTTTTTTMTTTTTTTTMTTTTTTTTTTTTTTTTTTTTTMTTTTTTTTTTTTTPPP
PPPTTTTTTTTTMTTTTTTTTTTTMMTTTTTTTTTTTTTTTTTMTTTTTTTTMTTTTTTTTMTTTTTTTTTTTTTTTTTTTTTMTTTTTTTTTTTTTPPP
PPPTTTTTTTTTMTTTTXTTTTTTTMTTTTTTTTTTTTTTTTTTTTTTXTTTTTTTTTTTTMTTTTTTTTTTTXTTTTTTTTTMTTTTTTTTTTTTTPPP
PPPTTTTTTTTTTTTTTTTTTTTTTMTTTTTTTTTTTTTTTTTMTTTTTTTTMTTTTTTTTMTTTTTTTTTTTTTTTTTTTTTMTTTTTTTTTTTTTPPP
PPPTTTTTTTTTMTTTTTTTTTTTTMTTTTTTTTTTTTTTTTTMTTTTTTTTMTTTTTTTTMTTTTTTTTTTTTTTTTTTTTTMTTTTTTTTTTTTTPPP
PPPTTTTTTTTTMTTTTTTTTTTTTMTTTTTTTTTTTTTTTTTMTTTTTTTTMTTTTTTTTMMMMMMMMMMMMMMMMMMMMMTMTTTTTTTTTTTTTPPP
PPPTTTTTTTTTMTTTTTTTTTTTTMTTTTTTTTTTTTTTTTTMTTTTTTTTMTTTTTTTTTTTTTTTTTTTTTTTTTTTTTTMTTTTTTTTTTTTTPPP
PPPTTTTTTTTTMMMMMMMMMMMMMMTTTTTTTTTTTTTTTTTMMMMMMMMMMTTTTTTTTMMMMMMMMMMMMMMMMMMMMMMMTTTTTTTTTTTTTPPP
PPPTTTTTTTTTTTTTTTTTTTTTTTTTTTTTTTTTTTTTTTTTTTTTTTTTTTTTTTTTTTTTTTTTTTTTTTTTTTTTTTTTTTTTTTTTTTTTTPPP
PPPTTTTTTTTTTTTTTTTTTTTTTTTTTTTTTTTTTTTTTTTTTTTTTTTTTTTTTTTTTTTTTTTTTTTTTTTTTTTTTTTTTTTTTTTTTTTTTPPP
PPPTTTTTTTTTTTTTTTTTTTTTTTTTTTTTTTTTTTTTTTTTTTTTTTTTTTTTTTTTTTTTTTTTTTTTTTTTTTTTTTTTTTTTTTTTTTTTTPPP
PPPTTTTTTTTTMMMMMMMMMMTTTTTTTTTTTTTTTTTTTTTMMMMMMMMMMTTTTTTTTMMMMMMMMMMMMMMMMMMMMMMMTTTTTTTTTTTTTPPP
PPPTTTTTTTTTMTTTTTTTTMTTTTTTTTTTTTTTTTTTTTTMTTTTTTTTMTTTTTTTTMTTTTTTTTTTTTTTTTTTTTTTTTTTTTTTTTTTTPPP
PPPTTTTTTTTTMTTTTTTTTMTTTTTTTTTTTTTTTTTTTTTMTTTTTTTTMTTTTTTTTMMTMMMMMMMMMMMMMMMMMMMMTTTTTTTTTTTTTPPP
PPPTTTTTTTTTMTTTTTTTTMMMTTTTTTTTTTTTTTTTTTTMTTTTTTTTMTTTTTTTTMTTTTTTTTTTTTTTTTTTTTTMTTTTTTTTTTTTTPPP
PPPTTTTTTTKTMTTTTTTTTTTMMTTTTTTTTTTTTTTTTTTMTTTTTTTTMTTTTTTTTMTTTTTTTTTTTTTTTTTTTTTMTTTTTTTTTTTTTPPP
PPPTTTTTTTTTMTTTTTTTTTTTMMTTTTTTTTTTTTTTTTTMTTTTTTTTMTTTTTTTTMTTTTTTTTTTXTTTTTTTTTTMTTTTTTTTTTTTTPPP
PPPTTTTTTTTTMTTTTTTTTTTTTMTTTTTTTTTTTTTTTTTTTTTTTTTTTTTTTTTTTMTTTTTTTTTTTTTTTTTTTTTMTTTTTTTTTTTTTPPP
PPPTTTTTTTTTTTTTTTXTTTTTTMTTTTTTTTTTTTTTTTTMTTTTTTTTMTTTTTTTTMTTTTTTTTTTTTTTTTTTTTTMTTTTTTTTTTTTTPPP
PPPTTTTTTTTTMTTTTTTTTTTTTMTTTTTTTTTTTTTTTTTMTTTTTTTTMTTTTTTTTMTTTTTTTTTTTTTTTTTTTTTMTTTTTTTTTTTTTPPP
PPPTTTTTTTTTMTTTTTTTTTTTTMTTTTTTTTTTTTTTTTTMTTTXTTTTMTTTTTTTTMMMMMMMMMMMMMMMMMMMMMTMTTTTTTTTTTTTTPPP
PPPTTTTTTTTTMTTTTTTTTTTTTMTTTTTTTTTTTTTTTTTMTTTTTTTTMTTTTTTTTTTTTTTTTTTTTTTTTTTTTTTMTTTTTTTTTTTTTPPP
PPPTTTTTTTTTMMMMMMMMMMMMMMTTTTTTTTTTTTTTTTTMMMMMMMMMMTTTTTTTTMMMMMMMMMMMMMMMMMMMMMMMTTTTTTTTTTTTTPPP
PPPTTTTTTTTTTTTTTTTTTTTTTTTTTTTTTTTTTTTTTTTTTTTTTTTTTTTTTTTTTTTTTTTTTTTTTTTTTTTTTTTTTTTTTTTTTTTTTPPP
PPPPPPPPPPPPPPPPPPPPPPPPPPPPPPPPPPPPPPPPPPPPPPPPPPPPPPPPPPPPPPPPPPPPPPPPPPPPPPPPPPPPPPPPPPPPPPPPPPPP
PPPPPPPPPPPPPPPPPPPPPPPPPPPPPPPPPPPPPPPPPPPPPPPPPPPPPPPPPPPPPPPPPPPPPPPPPPPPPPPPPPPPPPPPPPPPPPPPPPPP
PPPPPPPPPPPPPPPPPPPPPPPPPPPPPPPPPPPPPPPPPPPPPPPPPPPPPPPPPPPPPPPPPPPPPPPPPPPPPPPPPPPPPPPPPPPPPPPPPPPP
