30
30
PPPPPPPPPPPPPPPPPPPPPPPPPPPPPP
PPPPPPPPPPPPPPPPPPPPPPPPPPPPPP
PPPPPPPPPPPPPPPPPPPPPPPPPPPPPP
PPPSSSSSSSSSSSMMMMMMMMMMMMMPPP
PPPSSMMMMMMMMSMMMMMMMMMMMMMPPP
PPPSSSABSMMMMSMMMMMMMAAAMMMPPP
PPPMMMMMSSSMMSMMMMMMMADAMMMPPP
PPPMMMMMSSSMMSMMMMMMMMSMMMMPPP
PPPMMMMMSSSMMSMMMMMMMMSMSSSPPP
PPPMMMMMMSMMMSBBBBBBBBSASSSPPP
PPPMMMMMMSMMMSMMMMMMMMSMSSSPPP
PPPMMMSSSSMMMSMMMMMMMBSBMMMPPP
PPPMMMSMMMMMMSMMMMMMMBKBMMMPPP
PPPMMMSMMMMMMSMMMMSSSMMMMMMPPP
PPPMMMSMMMMMMSMMMMSDSMMMMMMPPP
PPPMMMSMMAAAMSMMMMSSSMMMMMMPPP
PPPMMMSSSAXSSSMMMMMSMMMMMMMPPP
PPPMMMSMMAAAMSMMMMMSMMMMAAAPPP
PPPMMMSMMMMMMSAAAAASAAAAAAAPPP
PPPMMMSMMMMMMSMMMMMSMMMMAAAPPP
PPPMMMSMMMMMMSBBBBBSMMMMMMMPPP
PPPMMMSMMBBBMSMMMMSSSMMMMMMPPP
PPPMMMSMMBKSSSMMMMSKSMMMMMMPPP
PPPMMMSMMBBBMSMMMMSSSMMMMMMPPP
PPPMMMSMMMMMMSMMMMMMMMMMMMMPPP
PPPMMMSMMMMMSSSMMMMMMMMMMMMPPP
PPPMMMSSSSSSSSSMMMMMMMMMMMMPPP
PPPPPPPPPPPPPPPPPPPPPPPPPPPPPP
PPPPPPPPPPPPPPPPPPPPPPPPPPPPPP
PPPPPPPPPPPPPPPPPPPPPPPPPPPPPP
