30
30
PPPPPPPPPPPPPPPPPPPPPPPPPPPPPP
PPPPPPPPPPPPPPPPPPPPPPPPPPPPPP
PPPPPPPPPPPPPPPPPPPPPPPPPPPPPP
PPPTTTTTTTTTTTAABTTTTBBBBTTPPP
PPPTMMMMMTTTTAABBBTTBBBBTTBPPP
PPPTMAAAMTTTTAABBBBTTBBTTBBPPP
PPPTMAAAMTTTTTAABBBTTBTTBBBPPP
PPPTMAAAMTTTKTAABBTTBBTTBBBPPP
PPPTMMMMMTTTTTAABBBTTBTTBBKPPP
PPPTTTTTTTTTTAABBBTTTTTTBBBPPP
PPPTTKTDTTTTTAABBBDTTTTBBBBPPP
PPPTTTTTTTTTTAABBBTTBBTTBBBPPP
PPPTTTTTTTTTTAABBTTTTBTTBBBPPP
PPPTTTTTTTTTTTAABTTTTTTBBBTPPP
PPPTTTTTTTTTTTAABTTBTTBBBTTPPP
PPPTTTTTTTTTTTBAATTTTBTBTTBPPP
PPPTTTTTTTTTTTTTBTTBTTTTTBBPPP
PPPTTTTTMMMMMMMTTTBTTTBTBBBPPP
PPPTTTTTMTTTTTMTTBTTBBBBBBBPPP
PPPTTTTTMTTTTTMTTTTTTBBBBBBPPP
PPPTTTTTMTTTTTTTBTTTTTBBBBBPPP
PPPTTTTTMTTTTTMTBBTTBTTBBBBPPP
PPPTTTTTMTTTTTMTBTTBBTTBBBBPPP
PPPTTTTTMMMMMMMTBBTTBBTTBBBPPP
PPPTTTTTTTTTTTTTBBBTTBBTTBBPPP
PPPTTTTTTDBBBBBTTXBBTTBTTBBPPP
PPPTTTTTTTBBBBTTBBBBBBTTBBBPPP
PPPPPPPPPPPPPPPPPPPPPPPPPPPPPP
PPPPPPPPPPPPPPPPPPPPPPPPPPPPPP
PPPPPPPPPPPPPPPPPPPPPPPPPPPPPP